Hurry, Only 7 left!	Urgency
In demand	Scarcity
Hurry! Only 2 left in stock	Scarcity
In Stock only 3 left	Scarcity
Hurry! Only 2 left	Scarcity
ONLY 8 LEFT	Scarcity
Limited Availability	Scarcity
894 Claimed! Hurry, only a few left!	Scarcity
4 items left	Scarcity
HURRY! EXCLUSIVE DEAL FOR YOU! 1 4 : 4 5	Urgency
Offer ends in	Urgency
Only 7 left in stock.	Scarcity
1 in Stock	Scarcity
Low Stock Alert: Only 8 left in inventory	Scarcity
Only 3 items left	Scarcity
87% offers claimed. Hurry up!	Scarcity
HURRY! ¬£32.99 UK DELIVERY ENDS SOON	Urgency
ONLY 3 LEFT	Scarcity
8 items left	Scarcity
96 ITEM(S) LEFT IN STOCK!	Scarcity
Only 1 left In Stock	Scarcity
Availability: Only 4 Left!	Scarcity
Your order is reserved for 09:54 minutes!	Urgency
This size has only 1 left in stock	Scarcity
HURRY! ONLY 2 LEFT IN STOCK!	Scarcity
DEAL ENDS IN 40:55:13	Urgency
Only 1 Left	Scarcity
Only 33 left	Scarcity
Hurry, only a few left!	Scarcity
Only 11 left!	Scarcity
Hurry! Only 6 left in stock	Scarcity
90% offers claimed. Hurry up!	Scarcity
18 In Stock	Scarcity
00:15:07:45	Urgency
Only 9 Left.	Scarcity
Your order is reserved for 09:14 minutes!	Urgency
Limited time remaining!	Urgency
Only 7 left in stock!	Scarcity
Only 5 item(s) left.	Scarcity
(only 5 left)	Scarcity
Only 11 Left In Stock	Scarcity
Your order is reserved for 08:48 minutes!	Urgency
11 11 Hours: 00 22 Minutes: 3223 3223 Seconds	Urgency
Only 1 Item(s) left	Scarcity
Hurry, Only a few left!	Urgency
Limited Time: $10 Off! Discount Reflected In Price!	Urgency
Hurry up! Prices increase in 0 DAYS 11 HRS 59 MINS 55 SECS	Urgency
Hurry, only 1 left!	Scarcity
Only 26 Left	Scarcity
LAST CHANCE - UP TO 70% OFF - ENDS IN: 20 HRS 28 MINS 30 SECS	Urgency
HURRY UP > 09H 42M 39S	Urgency
ONLY 2 LEFT IN STOCK!	Scarcity
Only few items left in stock	Scarcity
Only 1.75 yards left in stock!	Scarcity
Only 8 left	Scarcity
00DAYS00HOURS14MINUTES21SECONDS	Urgency
Hurry! Only 1 left in size M!!	Scarcity
Items in your cart are in high demand.	Scarcity
Limited stock Only 2 left	Scarcity
Over 500 left in stock	Scarcity
1 LEFT	Scarcity
Limited quantity remaining	Scarcity
128 sold today! Hurry, only a few left!	Scarcity
Limited Time Offer Limited Offer! 15% off on Naomi Home with Coupon 9N03. You pay $63.74	Urgency
HURRY! ONLY 1 IN STOCK!	Scarcity
LAST CHANCE TO ACTIVATE 10% OFF	Scarcity
Your order is reserved for 09:45 minutes!	Urgency
only 5 left	Scarcity
Hurry! Only Limited Items Left	Scarcity
Strong demand! Complete your order before it's too late!	Scarcity
Your order is reserved for 09:56 minutes!	Urgency
"LIMITED TIME OFFER 10% OFF - ENTER CODE \""CASES\"" AT CHECKOUT"	Urgency
803 Claimed! Hurry, only a few left!	Scarcity
Only 2 left!	Scarcity
ONLY A FEW LEFT IN STOCK	Scarcity
1day21:04:58	Urgency
Stock Low : 6 items left.	Scarcity
HURRY, LOW IN STOCK!	Scarcity
Only 4 copies left	Scarcity
2 LEFT	Scarcity
2 DAYS 13:06:13	Urgency
2 left in stock	Scarcity
Selling fast!	Scarcity
ON SALE: Select Seasonal T-Shirts only $19.99! Limited time only! Save Now!	Urgency
Your order is reserved for 09:58 minutes!	Urgency
LIMITED TIME! - Save $5 OFF Orders $70+ Coupon: SAVE5 - PLUS - Free Gift on Orders $125+	Urgency
Only 1 left in Stock	Scarcity
0 Days 2 Hours 57 Minutes 53 Seconds	Urgency
Only 34 Left!	Scarcity
HURRY, ORDER WITHIN 16h 59m 06s TO GET 35% OFF EVERYTHING* EXCL SALE & BEAUTY ENTER: DOLL35	Urgency
LAST CHANCE TO SAVE... enter your email to Save 20% on your first order 00 hours :29 minutes :43 seconds	Urgency
OFFER EXPIRES IN: YES NO Want 10% Off Your First Order? 7 minutes 35 seconds	Urgency
This item is in high demand.	Scarcity
ONLY 1 LEFT! GET IT NOW!	Scarcity
ONLY 4 LEFT	Scarcity
Limited quantity!	Scarcity
Hurry! Only 15 left!	Scarcity
Only a few more left!	Scarcity
0011Days:0088Hours:4411Minutes:21125445Seconds	Urgency
Only 4 items left in stock.	Scarcity
Ends in 1 Days, 4 Minutes, 44 Seconds	Urgency
In Stock - Limited Quantity	Scarcity
Only 8 left in stock. Almost Gone!	Scarcity
Limited time only: FREE SHIPPING on all orders, no minimum required!	Urgency
10 Left	Scarcity
Only 2 left	Scarcity
3Days01:49:51 Left	Urgency
Your order is reserved for 07:28 minutes!	Urgency
Only 1 left in stock	Scarcity
Only 1 left in stock! Get in quick!	Scarcity
You left 2 items in your bag Released in: 29 minutes :07 seconds	Urgency
Pre-order 3 left	Scarcity
Offer ends in 15hrs 1min 56sec!	Urgency
Hurry, this style is selling fast!	Scarcity
Hurry, only 3 left!	Scarcity
FREE NECKLACE FOR MOM 01Days 01Hrs 35Mins 02Secs	Urgency
Free Upgrade, Limited Time!\n*DISH Install Not Available*	Urgency
Going Fast: Limited Quantities Left!	Scarcity
Only 498 left	Scarcity
Hurry! Only a few of these left	Scarcity
Only 2 Left!	Scarcity
only 2 left	Scarcity
Only 1 Item Left!	Scarcity
HAUTELOOK 04:53	Urgency
Only 1 item left	Scarcity
* Limited Time Offer *\nFREE\nTLPWR1 Test Leads!	Urgency
Only 3 pieces in stock!	Scarcity
ONLY 3 LEFT IN STOCK.	Scarcity
Only 2 Left In Stock	Scarcity
LIMITED TIME ONLY!	Urgency
Now 30% off - hurry, limited time offer!	Urgency
HURRY! Only a few left in stock!	Scarcity
1 day 08:15:25	Urgency
Only 3 Left	Scarcity
ONLY 1 REMAINING	Scarcity
LIMITED QUANTITY	Scarcity
02:06:40 left to buy	Urgency
Last chance! Only 1 left	Scarcity
Sale ends soon:	Urgency
Only 16531 items left in stock!	Scarcity
Only 3 Left!	Scarcity
We only have few stocks left for this product. Please don't miss the chance.	Scarcity
Your order is reserved for 09:35 minutes!	Urgency
LIMITED TIME ONLY *on select models	Urgency
BE QUICK 00:57:33 DON'T MISS OUT	Urgency
35% OFF EVERYTHING* EXCL SALE & BEAUTY ENTER: DOLL35 - HURRY! ENDS IN  16H 59M 06S	Urgency
00Days17Hours12Mins13Secs	Urgency
Hurry, Limited Time Offer! 11:25	Urgency
Only 2 stock available	Scarcity
Hurry! Only 3 Left In Stock.	Scarcity
Hurry up! Sales Ends in DAYS HRS MINS SECS by Beeketing	Urgency
Only 8 items left in stock!	Scarcity
ONLY 1 LEFT IN STOCK!	Scarcity
FRAMON #2 Code Machine Offer - Limited time offer!	Urgency
Limited stock!	Scarcity
Hurry! Only 2 left in stock!	Scarcity
SLEEP EVENT OFFERS - LIMITED TIME ONLY	Urgency
Only 1 left in Stock!	Scarcity
Only 3 left In Stock	Scarcity
only 2 left!	Scarcity
Only 1 in stock	Scarcity
Only 8 item(s) left.	Scarcity
Spring Sale Extended	Urgency
SAVE $300.00\nfor limited time	Urgency
Currently 8 left in stock.	Scarcity
Currently less than 10 available	Scarcity
Ends Sunday! $200 off any mattress . free shipping & free returns!	Urgency
Only 8 left!	Scarcity
Only 1 items left in stock!	Scarcity
ONLY 1 WATCH LEFT	Scarcity
94% offers claimed. Hurry up!	Scarcity
Only 6 items left	Scarcity
23% left in stock!	Scarcity
In Stock. Only 1 Left!	Scarcity
Status:Only 3 left in stock	Scarcity
Today's sale ends in: 00hours:57min:19sec	Urgency
ONLY 7 LEFT!	Scarcity
OFFER ENDS 00:54:59	Urgency
LIMITED TIME SALE	Urgency
320 items left	Scarcity
HURRY! 3 left in stock!	Scarcity
(ONLY 1 LEFT IN THIS SIZE!)	Scarcity
Only 65 Items Left.	Scarcity
Only 3 left in stock.	Scarcity
In Stock, Only 1 Left!	Scarcity
Explosive Offers! 80% Off Everything 07:25:41	Urgency
Only 4 left	Scarcity
Hurry only 1 left!	Scarcity
Only 8 item(s) left	Scarcity
LOW IN STOCK, only 2 left	Scarcity
74% offers claimed. Hurry up!	Scarcity
Only 2 left in stock!	Scarcity
00 Days 02 Hrs 26 Mins 12 Sec Sale Ends Once The Timer Hits Zero!	Urgency
Your Cart Will Expire In 09:58 minutes!Please note that these items may not be available again if you release them.	Urgency
SAVE 10% On All Orders. No Voucher Code Needed Expires in 18:07:59.	Urgency
Only 9 Left!	Scarcity
Hurry! Only 2 left!	Scarcity
1 left at this price	Scarcity
ONLY 12.5M LEFT IN STOCK!	Scarcity
6 items left! Order soon.	Scarcity
ONLY 20 LEFT IN STOCK	Scarcity
ONLY 1 LEFT	Scarcity
Only 4 left!	Scarcity
Almost Sold Out! Only 2 Left.	Scarcity
Days left until the offer ends: 00 Days 04:43:35	Urgency
Only 2 items left in stock.	Scarcity
Only A Few Left	Scarcity
1 in stock	Scarcity
SAVE TODAY: Save 20% on lighting by Le Klint. Limited time only.	Urgency
Only 3 Left! Get it before it`s gone!	Scarcity
Hurry Up ! Just 2 Items Left in stock	Scarcity
Last 1 in stock	Scarcity
Only 1 left!	Scarcity
Only a few left	Scarcity
Limited stock available	Scarcity
Due To HIGH Demand, Cart Expires In: 08:41	Urgency
ONLY 3 LEFT! GET IT NOW!	Scarcity
Hurry up! Discount Ends in DAYS HRS MINS SECS	Urgency
Extremely high demand: expect 2-4 weeks for it to arrive (to be safe). Limit 4 per person!	Scarcity
Activate within 0:30:00	Urgency
Only 5 Left in Stock. Buy Soon!	Scarcity
83% offers claimed. Hurry up!	Scarcity
Clearance! Only 4 left in stock.	Scarcity
Only 4 Left!	Scarcity
Only 1 products left	Scarcity
1 left in stock	Scarcity
00DAYS02HRS14MINS1211SEC	Urgency
Hurry! Less than 10 left!	Scarcity
ONLY 13 LEFT	Scarcity
HURRY! DON'T MISS THIS DEAL! DAYS 0 1 HRS 1 2 MINS 3 1 SECONDS	Urgency
Only 1 item left in stock	Scarcity
Availability: In Stock Hurry! Only 8 Left!	Scarcity
Fewer than 5 left!	Scarcity
Hurry, before it is gone! Limited time remaining!	Urgency
Only 867 left	Scarcity
Only 2 units left in stock	Scarcity
Only one item left in stock!	Scarcity
LIMITED TIME DEAL!	Urgency
Only 3 available	Scarcity
Only 1 left in online stock	Scarcity
Hurry! Almost Sold Out...	Scarcity
Only 2 copies left	Scarcity
Limited Quantity Available	Scarcity
2 items left	Scarcity
Available, only 2 left	Scarcity
Limited Time!	Urgency
Your order is reserved for 08:53 minutes!	Urgency
OFFER ENDS: 09h: 09m: 55s: 0	Urgency
Hurry! Only 1 Pair left!	Scarcity
Flash Sale - Almost Over! 00 HOURS : 55 1001 MINUTES : 0550 8778 SECONDS	Urgency
Cart will expire in 04:53 minutes!	Urgency
Hurry, Only 4 Left In Stock. Buy Now!	Scarcity
Only 7 left	Scarcity
89% offers claimed. Hurry up!	Scarcity
20 units left	Scarcity
High demand	Scarcity
5 in stock	Scarcity
Only 1 left	Scarcity
Only 7 in Stock!	Scarcity
No thanks, I just want the item	Scarcity
Victoria Victoria Beckham	Scarcity
In stock, only 1 products left	Scarcity
Rain Boots	Scarcity
Exterior Accessories	Scarcity
How about one of these hot sellers?	Scarcity
Only 3 left	Urgency
No thanks, I don't want a free gift.	Urgency
2:59:50	Urgency
info@chainedandable.com	Scarcity
NO, I'D RATHER PAY FULL PRICE	Urgency
00DAYS00HOURS47MINUTES36SECONDS SALE ENDS ONCE COUNTER HITS ZERO	Scarcity
Entertainment Centers & TV Stands	Scarcity
STAY IN THE LOOP!	Urgency
1 left in stock. Hurry!	Urgency
Blue Raspberry	Scarcity
LIMITED TIME ONLY: FREE SHIPPING TO SELECT COUNTRIES ON ORDERS OVER $100!	Scarcity
No thanks, I like full price	Scarcity
Musical Toys	Urgency
Limited Time Offer!	Scarcity
3 people are looking at this product	Urgency
Shop all interactive whiteboards	Scarcity
Sign up to stay up to date on all White Cloud news and savings!	Scarcity
Only 1 Left in this Size!	Scarcity
All Brands A-Z	Urgency
CPUs & Processors	Scarcity
For more information about the VIP Rewards Club Membership, to purchase or terminate a membership, or to start or stop automatic renewal of a membership, contact Ross-Simons Customer Service by postal mail at: Ross-Simons, 9 Ross-Simons Drive, Cranston, Rhode Island 02920; or by email at customerservice@ross-simons.com; or by calling the VIP Rewards Club priority line at 800-835-3799.	Scarcity
Sayeeganesh in Chennai, India just bought Dhoni the Finisher T-Shirt an hour ago	Scarcity
Candy & Snacks	Urgency
65% of our customers added Surefit protection this year.	Urgency
Active Filters English English ‚úò Remove Filter	Urgency
Wedding Cross Stich & Embroidery Patterns	Scarcity
Choose Type of Cookies You Accept Using	Scarcity
(Only 5 Left)	Scarcity
Let's make sure you have everything else you need	Urgency
‚Ç™ ILS	Urgency
Cooling & Air Treatment	Urgency
Select Your Year	Scarcity
Only 20 left	Urgency
Brass Shankh	Scarcity
2 people are looking right now	Scarcity
Blankets Throws	Scarcity
Shop Disposables	Urgency
Limited-time Deal	Scarcity
Shop Men's Styles	Urgency
If you are one of those constantly devoted to healthy eating, weight loss plans,..	Scarcity
For a limited time, buy 2 Hydroxycut Hardcore Elite, 30 Servings for $30!	Urgency
FREE SHIPPING FOR A LIMITED TIME | PRICES ARE IN USD AND INCLUDE ALL IMPORT DUTIES.	Scarcity
TSX Remotes	Scarcity
33 people are eyeing this item!	Scarcity
No Thanks, I'd Rather Pay Full Price	Scarcity
Harry Potter	Urgency
Give a Gift	Urgency
Please note: we do not ship to PO Boxes	Scarcity
Free Shipping*	Scarcity
Crystals are alive. Born inside Mother Earth, crystal energy can be felt just like heat or cold. For chakra training to astrological remedies, discover healing crystals.	Urgency
ALMOST GONE - only 2 remaining!	Scarcity
Hurry, only 302 left.	Scarcity
ONLY 5 LEFT IN STOCK	Urgency
ONLY AVAILABLE FOR A LIMITED TIME	Scarcity
Help us #savethefishies.	Scarcity
5 items left	Scarcity
This product was viewed 26 seconds ago by someone from Princeton	Scarcity
Crochet Baby Patterns	Scarcity
Brand case & cloth included	Scarcity
Mallet E Speed Lace - Black/Silver	Scarcity
You may cancel your VIP membership at any time by calling 1-866-337-0906 (open 24/7).	Scarcity
Items in your cart are selling fast	Scarcity
No thanks, I don't like winning.	Urgency
Laundry Care	Scarcity
Deal Ends In 2 : DAYS13 : HRS10 : MIN24 SEC	Scarcity
This campaign was taken down for content reasons	Scarcity
AdjustableSnapbacksSale Items- View All -	Urgency
Bob Ross Oil Brushes	Scarcity
Lighting	Urgency
Computer Accessories	Scarcity
21 people looked at this during the last 24 hours	Scarcity
Black Jeans	Scarcity
Items in your cart are in high demand, but we have reserved your order.	Scarcity
167 piece(s) left for this promo	Scarcity
Only 32 left in stock	Urgency
CUSTOMER SERVICE	Scarcity
Hurry! Sale ends in:	Scarcity
Printed Long Sleeves Casual Blouse For Women	Scarcity
Straight Hair Extensions	Scarcity
No USB or Y-Adapter!? Our USB Sound Card is highly recommended for PC (Mac/Linux/Windows) and works with current gen consoles. The Y adapter is recommended for console gaming, phone, or other TRRS jacks.	Scarcity
Website Accessibility	Urgency
HURRY! YOUR 10% OFF EXPIRES IN 29:43	Scarcity
3 people bought this item last week.	Urgency
Only 8 left in stock	Urgency
This is how you can reject or delete your cookies	Urgency
No thanks, I don't want any deals	Scarcity
Toddler Boy Underwear and Undershirts	Urgency
HomeFlowersColourful Mixed Roses Bouquet	Scarcity
Send as giftexpand_more	Scarcity
Livefood Subscription	Urgency
Subscribe	Scarcity
JerseysPantsSleepwear & UnderwearSwim CollectionT-ShirtsSale Items- View All -	Scarcity
I love this phone case! üòç #phonecase #hiraeth #appleiphone #apple #rosegold #loveit	Scarcity
Travel Accessories	Urgency
eWriters & Graphics Tablets	Urgency
EU Delivery & Returns	Scarcity
Your order will be reserved for 6:56 minutes.	Urgency
Mobile Terms of Use	Scarcity
ALL SALE	Scarcity
JUST 1 LEFT!	Scarcity
LOGO BLACK	Urgency
Everything was perfect. The delivery was very smooth and the products were in great condition as well.	Scarcity
Lenscap: Damage Only	Scarcity
Don't miss out on this item! There is only 1 left in stock.	Urgency
Diamond Nose Studs	Urgency
Perhaps you could...	Scarcity
Casual V-Neck Sleeveless T-Shirt	Scarcity
Hurry only 8 items left!	Urgency
LIMITED TIME: $10 OFF! DISCOUNT REFLECTED IN PRICE!	Scarcity
Frequently Asked Questions	Scarcity
We value your input. Share your review so everyone else can enjoy it too.	Scarcity
Macro Focussing Rails	Urgency
Checkout within 04:10 so we don't run out of stock!	Scarcity
All Shoes	Scarcity
WARNING! Only 5 left in stock!	Scarcity
new merch coming soon	Urgency
Also notify me about New Arrivals!	Scarcity
POSTED BY @missladywoolf#motoin	Urgency
All Personalised Gifts	Urgency
Sorry! This product is no longer available	Scarcity
Only 2 Left	Scarcity
Colored Contact Lenses	Scarcity
only 7 pieces left	Urgency
Download Now	Scarcity
Hurry, limited quantities left!	Scarcity
#NAME?	Scarcity
Limited time offer.	Scarcity
Someone in Faizabad just bought: Pretty Love Penis Sleeve 7 inch an hour 2 minutes ago	Urgency
I WANT TO PAY MORE LATER ;)	Urgency
Jacob in Seymour, Wisconsin, United States purchased a Bass XL just now!	Scarcity
Delivery & support	Scarcity
No thanks, I don't like winning	Scarcity
Baby Cross Stitch & Embroidery Patterns	Scarcity
HHR remotes	Scarcity
Hurry! Only 1 Left In Stock	Scarcity
SAVE $200 OFF PUFFY	Scarcity
Data Processor Privacy Policy: https://triplelift.com/privacy	Scarcity
Tambria in Hattiesburg just bought Peruvian Virgin Natural Wave Hair 3 Bundles with Lace Frontal, 100% Human Virgin Hair	Scarcity
1 item left	Urgency
Order without free membership $69.95	Scarcity
This product can expose you to chemicals including Hexavalent which is known to the State of California to cause cancer on birth defects or other reproductive harm. For more information, visit	Urgency
Only 5 left!	Scarcity
Only 3 Left in Stock!	Scarcity
Hurry! Only 6 left in stock.	Scarcity
powered by: Cookie Information	Scarcity
No Thanks, I Don't Want To Save	Urgency
commonpandacom@commonpandacom	Scarcity
Yes, I Want To Save Money!No Thanks	Scarcity
407 customers have viewed this item recently	Scarcity
I have a strong liking to walnut. Even the sapwood can look very presentable when finished good. Thus cutting board is a great item for use and conversation and looks good.	Scarcity
Holland Cooper	Scarcity
6 people have looked at this in the last few hrs.	Urgency
Why I chose this:	Urgency
TWO FREE PILLOWS AND 30% OFF WITH PROMO CODE	Urgency
View Alternatives	Urgency
Jim in Houston, USA purchased Pure Ratios: Hemp Oil CBD Patch (40mg CBD)	Urgency
Only 22 left in stock!	Urgency
ADD WORLD'S MOST COMFORTABLE CHAIRS	Urgency
ONLY 3 LEFT IN STOCK!	Scarcity
View all Oil & Acrylic Brushes categories	Urgency
Someone in Louisville Kentucky United States Purchased Gold Presidential Bracelet With Watch Buckle 9 hours ago	Urgency
[new-troh-pick]	Scarcity
Long and Tall	Urgency
Only 9 left	Scarcity
Your order has been reserved for	Urgency
Only 1 items left	Urgency
Would you like to purchase an Extended Protection Plan?	Urgency
Not sold separately	Scarcity
Redirecting to Futech Deals for secure checkout...	Urgency
*Freight/Higher Freight charges may apply to some areas. Click here to view Shipping Policy	Scarcity
Covered all grays	Scarcity
Only available for a LIMITED TIME, so get yours TODAY!	Scarcity
2 in stock	Urgency
Oxfords & Loafers	Scarcity
An item you ordered is in high demand. No worries, we have reserved your order.	Scarcity
HURRY, THERE ARE ONLY 9 ITEM(S) LEFT!	Urgency
Trending Style! Sold 4 times today	Scarcity
Limited Quantity	Scarcity
LIVE REMAINING STOCK	Scarcity
Only 2 left in stock	Urgency
If you wish to cancel a membership, please contact our Customer Services Department on UK: +44 808 164 8264 (standard local call charges will apply) or via email on customer.service@beautypie.com. You can also contact the Customer Services Department by post at: Beauty Pie Limited, Customer Service Department, The Point, 210 New Kings Road, London SW6 5NZ, United Kingdom. Please quote your order number in all correspondence.	Scarcity
Flex Mount	Scarcity
from France	Scarcity
style to command	Urgency
Only 5 left in stock	Scarcity
LIMITED TIME: FREE SHIPPING LOWERED TO ORDERS OVER $69.95!	Scarcity
sweatshirts	Urgency
On Sale! Limited Time Offer!	Urgency
Sierra in Cypress, California bought Beauty In All Dress, Dusty Blue about 46 minutes ago	Scarcity
Bath Decor	Scarcity
Household	Scarcity
mens long sleeve organic shirt	Urgency
These cookies are usually set by our marketing and advertising partners. They may be used by them to build a profile of your interest and later show you relevant ads. If you do not allow these cookies you will not experience targeted ads for your interests.	Urgency
20% OFF VALENTINE\u2019S DAY FAVOURITES * | LIMITED TIME ONLY	Scarcity
Availability: Low in stock today	Scarcity
*Only 2 left in stock. Don't miss out!	Scarcity
NO THANKS, I DON'T WANT TO SAVE MONEY	Scarcity
PopGrip Antimicrobial Refine by Product Type: PopGrip Antimicrobial	Urgency
117 people have viewed this item in the last 7 days.	Scarcity
Only 1 left in stock! Order soon!	Scarcity
SUPPORT THE AMERICAN SUPRESSOR ASSOCIATION	Scarcity
Custom Board Quote	Scarcity
I have not had my hair so soft and shiny in such a long time and my grey was completely covered! So incredibly happy.	Scarcity
View all	Scarcity
ÈüìÂúãÈ¶ôÊ∞õ Cosmic Mansion	Scarcity
Shoe Care	Scarcity
Tristan in Markham, Canada purchased a Dragon Baseball Jersey	Scarcity
7 left in stock	Urgency
Platinum-Dipped Rose	Scarcity
5 LEFT	Scarcity
Rs 4,013 (Retail Discount) + Rs 2,997 (Limited Time Coupon)	Scarcity
12 recently purchased it.	Scarcity
Vintage Fancy Red Bracelet Watch Women's	Urgency
404 Orders	Scarcity
50% OFF Everything (yep, even sale) + $5.99 Shipping* ENDS IN 12h 13m 56s	Scarcity
Tyler in Norwalk, United States purchased a	Urgency
#6 Bestseller in Rugs This item was viewed 92 times in the last day.	Urgency
Upcoming Events	Scarcity
Beetle Remotes	Urgency
Gut Health	Scarcity
Dog Collars, Leads & Tethers	Scarcity
Optimized Patch System	Scarcity
Someone in Culgoa, Australia purchased Savelli Epic Mens Comfortable Leather Lace Up Boots Made In Brazil	Urgency
I don't want a discount	Scarcity
Trey in Columbia, United States purchased Leather Cord Capsule	Scarcity
No thanks, I‚Äôll skip this amazing super-saver deal. I don‚Äôt need so many beautiful textures	Scarcity
Vacation One Shoulder Loosen Long Sleeve Woven Dress	Urgency
Other Applications	Scarcity
High Gable Sheds	Urgency
Used Leica Cameras	Scarcity
Personalize your doll	Scarcity
Someone from Osijek, Croatia just bought TMC CP Style Single Pistol Pouch	Scarcity
The World Fair Trade Organization Label guarantees that People Tree follows Fair Trade best practices in our organisation.	Urgency
No thanks, I don't want to look my best	Scarcity
Thermostats	Urgency
ONLY 5 LEFT, ORDER SOON!	Scarcity
Only 1 Left!	Urgency
Sorry, this is out of stock. You just missed it.	Scarcity
3 Left!	Scarcity
Only 1 left.	Urgency
Tidal Waves Collection	Scarcity
Gifts By Price	Scarcity
Hurry up! 22 people other than you have this product in their cart	Scarcity
beautifully written prose	Scarcity
156 sold in last 24 hours	Scarcity
ON SALE AT $1.99 FOR A LIMITED TIME	Scarcity
Submitted by Fermin Larracilla P√©rez	Scarcity
Polycarbonate	Urgency
Ken in Oakland, United States purchased a Dreamville Hoodie a month ago	Scarcity
17 people have added this item to cart	Urgency
00 DAYS 00 HOURS 29 MINUTES 26 SECONDS	Urgency
Sponges, Mitts & Bath Brushes	Scarcity
No thanks. I don‚Äôt want to save money.	Urgency
New In Bottoms	Scarcity
In Stock (8) Left	Scarcity
Your cart is reserved for 14:05 minutes!	Scarcity
In Stock Only 5 left!	Scarcity
Exotic Bird Food	Scarcity
AN ITEM IN YOUR CART IS SELLING OUT QUICKLY	Scarcity
iPhones	Urgency
Hurry Up! Only 1 Piece Left	Scarcity
Summer Simple Breathable Socks	Scarcity
No thanks, I don‚Äôt like saving money.	Scarcity
Value of Product	Scarcity
00DAYS07HOURS09MINUTES39SECONDS	Scarcity
Mountboard	Scarcity
Light powerful.	Urgency
Availability: Low Stock 4 Remaining	Urgency
Samuel in Minneapolis, United States purchased a Pod Juice Jewel Mint Cool ‚ùÑÔ∏èNicotine Salt e-Liquid 15/30ml 7 hours ago	Urgency
Boardshorts	Scarcity
Sign Up To Our Newsletter To Receive News, Offers And Promotions.	Urgency
(LIMITED TIME OFFER) TORSION GUN HOLSTER SUPER COMBO	Scarcity
Dog Whistles & Lanyards	Urgency
Other people want this. 10 people have this in their cart right now.	Urgency
Terms of Use Privacy Policy Do Not Sell My Personal Information Request My Personal Information	Scarcity
Colors	Scarcity
1 person is looking at this item.	Urgency
Someone in Petaling Jaya, Malaysia just bought SNEAKERGUARD Midsole Paint Marker - BOOST White	Scarcity
72% offers claimed. Hurry up!	Urgency
WilmaNorth Carolina	Urgency
TV & Home Appliances	Urgency
Wigsbuy- Online Beauty Store of Fashion Wigs, Hair Extensions & Accessories for Sale.	Scarcity
Quick Navigation	Scarcity
CHF	Scarcity
Clinical Studies	Scarcity
¬∑ Physical Healing	Scarcity
Sign in & make your visit all about you	Urgency
No thanks, I don't want discount	Scarcity
228 People Have Viewed This Product Recently!	Scarcity
Shop all	Urgency
HURRY! ONLY 58 LEFT IN STOCK!	Scarcity
Be the first to get updates as well as access to exclusive offers and promotions	Scarcity
Hayden near Princeton just bought!!!: CBD VEGAN GUMMIES	Urgency
help@postergully.com	Scarcity
Men's Sports Bottoms	Urgency
Hurry Up ! Time is running out	Scarcity
Low Price Guarantee	Scarcity
Someone in Arden Hills, United States purchased 120ml Young Napoleon | Best Strawberry Shortcake eJuice | Vaporham Lincoln eLiquid about 42 minutes ago	Scarcity
Only 10 left in stock	Scarcity
John Boos	Urgency
Get inspiration, new arrivals and the latest offers to your inbox.	Urgency
11 people have purchased this item	Urgency
Prior to the automatic renewal and billing, we will notify you in advance (via the email you used at the time of enrollment) of (i) the pending renewal, (ii) the then current fees and charges applicable to the Passport Program, and (iii) where you may find more information about the Passport Program. We will also send you an additional email confirming your renewal. Should you elect not to renew your Membership, you may cancel at any time prior to the renewal by emailing us at passportmembership@1800flowers.com and your credit/debit card on file with us will not be charged. A confirmation email will be sent to you.	Scarcity
Baby Size Guide	Urgency
161 people have viewed this item	Scarcity
Only 2 left.	Scarcity
Gameday Collection	Scarcity
Whoops!	Scarcity
Rick in Columbia, United States purchased a	Scarcity
Welcome Newcomer	Urgency
Plus Size Shirts and Blouses	Scarcity
A Date With Duchess	Scarcity
Only 3 left.	Urgency
Active Filters English (United States) English (United States) ‚úò Remove Filter	Scarcity
Hurry up! Sale Ends in	Scarcity
Red Tops	Scarcity
JOINT Oil	Urgency
Speed Lace Accessory Kit - Silver	Scarcity
Comfy and looks great	Scarcity
FREE SHIPPING // FOR A LIMITED TIME ONLY	Urgency
Find your local store, view opening hours and find out where you can get your latest pickup in-store!	Scarcity
Resend One time Pin	Urgency
Natalie in Graham, United States purchased a FREE BTS Answer Magic Pillow about 1 hour ago	Scarcity
No I'd rather not hear about exclusive offers and discounts.	Urgency
View your order history	Scarcity
Only 13 left!	Scarcity
40% OFF EVERYTHING* ENTER: 40PLT + FREE SHIPPING ON ALL ORDERS OVER $80	Urgency
Fashion Forward	Urgency
You may cancel your Minted More membership at any time by contacting Minted Customer Service at www.minted.com/help. If you cancel your membership before your Minted More gift box has shipped, we will refund your full membership fee; provided that we may charge you (or withhold from your refund) the value of Minted More discount benefits used by you and your account prior to cancellation. If you cancel at any other time, your membership fee is non-refundable.	Urgency
Your order is reserved for 29:52 minutes!	Urgency
For any other inquiries, Click here	Urgency
LIMITED TIME ONLY	Scarcity
Only 9 left!	Scarcity
Mher from San Angelo, TX Recently made a purchase with Crossrope	Urgency
No thanks. I love chaos!	Scarcity
Show Cart	Scarcity
Lean To Sheds	Scarcity
DressesFootwearHatsHoodies & SweatshirtsJerseysPantsSleepwear & UnderwearSwim CollectionT-ShirtsSale Items- View All -	Scarcity
